WWWWWWWWWWWWWWWWWWWWW
WFFEFFWFWFWFWFFFWFFFW
WFWFWFWFWFWFWFWFFFWFW
WFWFWFWFWFWFWFWWWFWFW
WFFFFFFFFBFFFEFFFFWFW
WFWFWWWWWFWWWFWFWWWFW
WFWFFFWFFFFFFFWFFFWFW
WFWFWFWFWWWFWFWFWFWFW
WFFFWFFFW WFWFFFWFFFW
WWWFWWWF PWFWWWFWWWBW
WFFFWFFFW WFWFFFWFFEW
WFWFWFWFWWWFWFWFWFWFW
WBWFFFWFFFFEFFWFFFWFW
WFWFWWWWWFWWWFWFWWWFW
WFFEFFFFFFFFFFFFFFWFW
WFWFWFWFWFWFWFWWWFWFW
WFWFWFWFWFWFWFWFFFWFW
WFFFFFWFWBWFWFFFWFFFW
WWWWWWWWWWWWWWWWWWWWW